	Condition1	Condition2
AAACGGGCAACCGCCA-1	Senescence1	RIS
AAACGGGGTCCAGTAT-4	Growing2	Growing
AAACGGGGTGCCTGCA-1	Senescence1	RIS
AAAGATGGTAGAAGGA-3	Growing1	Growing
AAAGCAATCCTAGAAC-1	Senescence1	RIS
AAAGCAATCGCCTGTT-1	Senescence1	RIS
AAAGTAGTCTCTTATG-1	Senescence1	RIS
AAATGCCTCACTTATC-3	Growing1	Growing
AACACGTAGGCTAGAC-3	Growing1	Growing
AACCATGGTCTCCCTA-4	Growing2	Growing
AACCGCGAGCACGCCT-1	Senescence1	RIS
AACTCCCCACACCGAC-1	Senescence1	RIS
AACTCCCGTAATAGCA-3	Growing1	Growing
AACTCCCTCGGGAGTA-3	Growing1	Growing
AAGACCTTCTTGCCGT-1	Senescence1	RIS
AAGCCGCGTTAAAGAC-3	Growing1	Growing
AAGCCGCTCAGAAATG-3	Growing1	Growing
AAGGTTCAGACAGGCT-1	Senescence1	RIS
AAGGTTCAGGTCATCT-4	Growing2	Growing
AATCGGTCATCACGAT-1	Senescence1	RIS
ACACCCTCATCCTTGC-1	Senescence1	RIS
ACACCGGTCATTCACT-1	Senescence1	RIS
ACACCGGTCTTTAGTC-4	Growing2	Growing
ACACTGAAGAGTACAT-3	Growing1	Growing
ACACTGAGTTCCACAA-1	Senescence1	RIS
ACACTGATCCAAATGC-1	Senescence1	RIS
ACAGCTAGTGGTACAG-1	Senescence1	GFP
ACAGCTAGTTAAGGGC-3	Growing1	Growing
ACATACGTCATTATCC-1	Senescence1	RIS
ACATCAGTCGCATGGC-1	Senescence1	RIS
ACCCACTAGACTAGAT-1	Senescence1	RIS
ACCGTAACAGGCTGAA-1	Senescence1	GFP
ACCGTAAGTCAAGCGA-1	Senescence1	GFP
ACCTTTAGTCTGGAGA-1	Senescence1	RIS
ACGAGCCGTAGGCTGA-3	Growing1	Growing
ACGAGGAAGACTTGAA-1	Senescence1	RIS
ACGAGGAGTTGAGTTC-1	Senescence1	RIS
ACGAGGATCTCCAGGG-1	Senescence1	RIS
ACGCAGCAGTCCAGGA-3	Growing1	Growing
ACGCAGCGTAGTGAAT-1	Senescence1	RIS
ACGCCAGTCACCTTAT-4	Growing2	Growing
ACGCCGACAAGGACTG-3	Growing1	Growing
ACGGAGAAGAGGGATA-1	Senescence1	RIS
ACGGAGACACACATGT-1	Senescence1	RIS
ACGGAGATCCAAGCCG-3	Growing1	Growing
ACGGGCTAGCCAGTTT-1	Senescence1	RIS
ACGGGCTTCACGGTTA-3	Growing1	Growing
ACGTCAACACGAGAGT-3	Growing1	Growing
ACTATCTAGCCTCGTG-4	Growing2	Growing
ACTATCTAGCGTAATA-1	Senescence1	RIS
ACTGAACTCTAACTTC-1	Senescence1	RIS
ACTGAGTCACCTGGTG-1	Senescence1	RIS
ACTGAGTTCAGCTCGG-1	Senescence1	RIS
ACTTACTTCCCTCTTT-4	Growing2	Growing
ACTTTCAGTTAGATGA-1	Senescence1	RIS
AGAATAGCACCATGTA-1	Senescence1	RIS
AGAATAGGTCGAATCT-4	Growing2	Growing
AGACGTTCAGCTTCGG-1	Senescence1	RIS
AGAGCGAGTGCCTTGG-3	Growing1	Growing
AGAGCGATCTGTCAAG-1	Senescence1	RIS
AGAGTGGAGTCCCACG-3	Growing1	Growing
AGAGTGGGTTCGGCAC-4	Growing2	Growing
AGATTGCAGGACACCA-3	Growing1	Growing
AGATTGCCATGCCTAA-1	Senescence1	RIS
AGCATACTCCACGTTC-1	Senescence1	RIS
AGCCTAAGTCGCCATG-1	Senescence1	RIS
AGCGGTCGTAGCGCAA-1	Senescence1	RIS
AGCTCTCTCAGGATCT-1	Senescence1	RIS
AGCTTGACACACCGCA-1	Senescence1	GFP
AGCTTGACAGTAACGG-1	Senescence1	RIS
AGGCCACAGGCTACGA-1	Senescence1	RIS
AGGCCGTGTTTGACAC-4	Growing2	Growing
AGGGTGACAGCGATCC-1	Senescence1	RIS
AGGTCATCACTTACGA-3	Growing1	Growing
AGGTCCGGTTACGACT-1	Senescence1	GFP
AGTCTTTCACTTAACG-1	Senescence1	RIS
AGTGAGGCAGGGTACA-1	Senescence1	RIS
AGTGGGAGTTGTCGCG-3	Growing1	Growing
AGTGTCAAGCGATGAC-4	Growing2	Growing
AGTTGGTAGATAGTCA-4	Growing2	Growing
ATAACGCAGAATGTTG-1	Senescence1	RIS
ATAACGCAGCCATCGC-4	Growing2	Growing
ATAACGCTCAGCGATT-1	Senescence1	GFP
ATAAGAGCAATCGGTT-3	Growing1	Growing
ATCACGATCTGTCTCG-3	Growing1	Growing
ATCATCTCAATGGAAT-1	Senescence1	RIS
ATCATGGGTCCCGACA-3	Growing1	Growing
ATCCGAACACTGTGTA-1	Senescence1	GFP
ATCGAGTAGAATCTCC-1	Senescence1	RIS
ATCTGCCGTGTCAATC-1	Senescence1	RIS
ATCTGCCTCAGGCGAA-3	Growing1	Growing
ATGCGATAGAATGTGT-1	Senescence1	RIS
ATGCGATTCGCAAACT-3	Growing1	Growing
ATGGGAGAGACTAGAT-1	Senescence1	RIS
ATGGGAGCAGGACGTA-1	Senescence1	GFP
ATGGGAGCATCGATGT-3	Growing1	Growing
ATGTGTGAGCAATATG-3	Growing1	Growing
ATTACTCGTCAAGCGA-4	Growing2	Growing
ATTACTCTCCATTCTA-3	Growing1	Growing
ATTATCCTCCTAAGTG-1	Senescence1	RIS
ATTATCCTCTGTGCAA-1	Senescence1	RIS
ATTGGTGTCTTACCGC-4	Growing2	Growing
CAACCAATCCATTCTA-1	Senescence1	RIS
CAAGATCAGGACAGCT-1	Senescence1	RIS
CAAGATCGTAAGTAGT-4	Growing2	Growing
CAAGGCCTCCCATTTA-1	Senescence1	RIS
CAAGTTGAGTTACGGG-3	Growing1	Growing
CAAGTTGTCTCCGGTT-1	Senescence1	RIS
CACAAACAGTGGAGAA-4	Growing2	Growing
CACACAAAGACACTAA-1	Senescence1	GFP
CACACAACACCGCTAG-1	Senescence1	GFP
CACACAATCACCGGGT-1	Senescence1	RIS
CACACCTTCAGCACAT-3	Growing1	Growing
CACACTCCAATCCGAT-4	Growing2	Growing
CACACTCTCTTGGGTA-1	Senescence1	RIS
CACAGTAAGAATTGTG-3	Growing1	Growing
CACAGTAAGCCGATTT-4	Growing2	Growing
CACAGTAAGTAAGTAC-1	Senescence1	RIS
CACAGTATCACCATAG-3	Growing1	Growing
CACAGTATCCAGGGCT-1	Senescence1	GFP
CACATAGTCACAATGC-1	Senescence1	RIS
CACATAGTCTGCAAGT-1	Senescence1	RIS
CACATTTAGGGCTTGA-1	Senescence1	RIS
CACATTTTCCATTCTA-4	Growing2	Growing
CACCACTTCTATCGCC-4	Growing2	Growing
CACCAGGTCGCAAACT-1	Senescence1	GFP
CACCTTGCACACAGAG-1	Senescence1	RIS
CACCTTGTCCAAAGTC-1	Senescence1	RIS
CACTCCAAGAGTACCG-3	Growing1	Growing
CAGCCGACAGCTGTGC-3	Growing1	Growing
CAGCCGATCCTATGTT-1	Senescence1	RIS
CAGCTGGCACCCTATC-4	Growing2	Growing
CAGCTGGGTAAGGGCT-1	Senescence1	RIS
CAGCTGGGTCACCTAA-1	Senescence1	RIS
CAGGTGCAGGATGGTC-4	Growing2	Growing
CAGGTGCTCCTGCTTG-1	Senescence1	RIS
CAGTAACTCTATCCCG-3	Growing1	Growing
CATATTCGTTAAAGTG-1	Senescence1	RIS
CATCAAGAGAGTGAGA-1	Senescence1	RIS
CATCGAAGTTCCACGG-1	Senescence1	RIS
CATCGGGTCGTTGCCT-1	Senescence1	GFP
CATGACAAGGTTACCT-1	Senescence1	RIS
CATGACACACCGATAT-1	Senescence1	RIS
CATGCCTTCGTACCGG-1	Senescence1	RIS
CATGCCTTCTCAAACG-1	Senescence1	GFP
CATGGCGTCTGTTTGT-1	Senescence1	RIS
CATTATCCAGTTCCCT-3	Growing1	Growing
CATTATCGTCTGGAGA-1	Senescence1	RIS
CATTATCTCATATCGG-3	Growing1	Growing
CATTCGCGTCCTGCTT-3	Growing1	Growing
CATTCGCGTCGACTGC-1	Senescence1	RIS
CCAATCCAGATGGCGT-4	Growing2	Growing
CCAATCCTCAGAGGTG-4	Growing2	Growing
CCACCTACACCATCCT-4	Growing2	Growing
CCACTACTCAGCGACC-1	Senescence1	RIS
CCATGTCAGTGTTTGC-4	Growing2	Growing
CCATGTCGTGTGAAAT-1	Senescence1	RIS
CCATGTCTCCAATGGT-3	Growing1	Growing
CCATTCGGTACGCTGC-1	Senescence1	GFP
CCCAGTTCAAGCGTAG-4	Growing2	Growing
CCCAGTTCATGGTCAT-3	Growing1	Growing
CCCAGTTGTATATGAG-1	Senescence1	RIS
CCGGGATGTAGAGGAA-3	Growing1	Growing
CCGGGATGTTGGAGGT-4	Growing2	Growing
CCGGTAGAGAGGTACC-1	Senescence1	RIS
CCGTGGACAGCTCCGA-1	Senescence1	GFP
CCGTTCAGTGTAACGG-1	Senescence1	RIS
CCTACACTCACTTACT-1	Senescence1	RIS
CCTAGCTCACCTCGTT-1	Senescence1	GFP
CCTATTAGTCGGCTCA-1	Senescence1	RIS
CCTATTAGTGTAACGG-4	Growing2	Growing
CCTCTGAAGAGACTAT-1	Senescence1	RIS
CCTCTGAAGGGAGTAA-1	Senescence1	RIS
CCTCTGAAGTGGTCCC-1	Senescence1	RIS
CCTTACGAGCTAACTC-1	Senescence1	RIS
CCTTCCCCACCCATTC-1	Senescence1	RIS
CCTTCCCCATTGGCGC-1	Senescence1	RIS
CCTTCCCTCCTAGTGA-4	Growing2	Growing
CCTTCGACATCCTAGA-1	Senescence1	RIS
CCTTCGAGTCTCGTTC-1	Senescence1	RIS
CCTTCGATCCACGAAT-1	Senescence1	RIS
CGACTTCAGGGATGGG-4	Growing2	Growing
CGAGAAGCACATCTTT-4	Growing2	Growing
CGAGAAGGTGAAAGAG-1	Senescence1	RIS
CGAGAAGTCACTGGGC-3	Growing1	Growing
CGAGCCAGTGTGGTTT-1	Senescence1	GFP
CGAGCCAGTTCCCGAG-3	Growing1	Growing
CGATCGGGTACCGGCT-1	Senescence1	RIS
CGATGGCTCCGCGGTA-3	Growing1	Growing
CGATGTAAGGACACCA-3	Growing1	Growing
CGATTGACAATGGACG-1	Senescence1	RIS
CGCCAAGGTGCAGGTA-4	Growing2	Growing
CGCTATCTCAACGGCC-1	Senescence1	RIS
CGCTGGAAGAACAATC-1	Senescence1	RIS
CGCTTCAGTACTCTCC-3	Growing1	Growing
CGGACACAGTTAAGTG-1	Senescence1	RIS
CGGACACGTTCAGGCC-4	Growing2	Growing
CGGACGTAGGCATGTG-3	Growing1	Growing
CGGACGTGTAGCTCCG-3	Growing1	Growing
CGGACTGCAACTGCTA-1	Senescence1	RIS
CGGAGTCAGGCCGAAT-1	Senescence1	RIS
CGGAGTCCAGTGGGAT-1	Senescence1	RIS
CGGAGTCGTACCTACA-3	Growing1	Growing
CGGAGTCTCACAGTAC-4	Growing2	Growing
CGGGTCATCAGGCAAG-1	Senescence1	RIS
CGGTTAACAGGCGATA-1	Senescence1	RIS
CGTAGCGGTAATCGTC-1	Senescence1	RIS
CGTAGCGGTTAAAGTG-3	Growing1	Growing
CGTCTACCACCACCAG-1	Senescence1	RIS
CGTCTACTCAACCAAC-3	Growing1	Growing
CGTGTAACACGCGAAA-4	Growing2	Growing
CGTGTAATCTGAGGGA-3	Growing1	Growing
CGTTCTGAGTGTACGG-1	Senescence1	RIS
CGTTCTGTCAGCGATT-1	Senescence1	RIS
CTAACTTAGGACATTA-4	Growing2	Growing
CTAACTTCATAAAGGT-3	Growing1	Growing
CTAAGACGTTCTGTTT-1	Senescence1	RIS
CTAATGGAGACCTTTG-4	Growing2	Growing
CTACACCTCACCATAG-4	Growing2	Growing
CTACACCTCTACCTGC-1	Senescence1	RIS
CTACCCAAGAAACGCC-1	Senescence1	RIS
CTACCCACAATGACCT-3	Growing1	Growing
CTAGTGACAGTAAGCG-1	Senescence1	RIS
CTCAGAACAAGACGTG-1	Senescence1	RIS
CTCAGAAGTCGCATCG-1	Senescence1	RIS
CTCAGAAGTCTCTTTA-1	Senescence1	RIS
CTCATTAGTGAAATCA-3	Growing1	Growing
CTCGAAATCGGAGCAA-3	Growing1	Growing
CTCGAGGGTGCAGTAG-1	Senescence1	RIS
CTCGTACCATTTCACT-1	Senescence1	RIS
CTCTAATAGTAGGTGC-3	Growing1	Growing
CTCTAATCACGACTCG-4	Growing2	Growing
CTCTAATCACTTAACG-1	Senescence1	RIS
CTCTACGCATTTCACT-1	Senescence1	RIS
CTCTACGGTTATCACG-4	Growing2	Growing
CTCTGGTGTCAACTGT-1	Senescence1	RIS
CTGAAACCACACGCTG-4	Growing2	Growing
CTGAAACTCTACTATC-1	Senescence1	RIS
CTGATCCGTCCAGTGC-1	Senescence1	RIS
CTGATCCGTGCCTGCA-1	Senescence1	RIS
CTGCGGATCATGCATG-1	Senescence1	RIS
CTGCTGTCATTACGAC-1	Senescence1	RIS
CTGTTTAAGTCAAGGC-4	Growing2	Growing
CTTAACTTCTTGGGTA-1	Senescence1	RIS
CTTACCGAGATGTGTA-1	Senescence1	RIS
CTTACCGAGCGTTGCC-1	Senescence1	RIS
CTTAGGAGTGGTCCGT-1	Senescence1	GFP
CTTAGGATCGAGGTAG-1	Senescence1	GFP
CTTCTCTAGTCGTACT-1	Senescence1	RIS
CTTCTCTTCAGTTGAC-1	Senescence1	RIS
CTTGGCTAGCCCAGCT-3	Growing1	Growing
GAAACTCAGCTGTTCA-3	Growing1	Growing
GAAACTCAGGAATGGA-4	Growing2	Growing
GAAACTCCAGCCTGTG-1	Senescence1	RIS
GAAATGAAGCGTGTCC-1	Senescence1	RIS
GAACATCCAGTTCATG-4	Growing2	Growing
GAACATCGTCTAGGTT-1	Senescence1	RIS
GAACCTAGTTTGCATG-1	Senescence1	RIS
GAACGGAAGTGTACGG-1	Senescence1	RIS
GAAGCAGGTTGGTGGA-1	Senescence1	RIS
GAATGAAGTAAATGAC-3	Growing1	Growing
GACACGCCATCCTAGA-4	Growing2	Growing
GACACGCGTTATGCGT-3	Growing1	Growing
GACAGAGAGCCGATTT-1	Senescence1	RIS
GACAGAGAGTCAAGGC-3	Growing1	Growing
GACAGAGGTTGTACAC-1	Senescence1	RIS
GACCTGGAGGCGCTCT-1	Senescence1	RIS
GACCTGGGTAGCAAAT-4	Growing2	Growing
GACGCGTGTCATGCCG-1	Senescence1	RIS
GACGTTAAGCTAAGAT-3	Growing1	Growing
GACTAACAGCGTTTAC-4	Growing2	Growing
GACTAACGTGCAGACA-1	Senescence1	GFP
GACTACACATATGCTG-3	Growing1	Growing
GAGGTGAGTGCGCTTG-4	Growing2	Growing
GAGTCCGTCCGTTGCT-3	Growing1	Growing
GAGTCCGTCTTAGAGC-3	Growing1	Growing
GAGTCCGTCTTGCATT-1	Senescence1	RIS
GATCGATGTCGAAAGC-1	Senescence1	GFP
GATCGCGAGCACAGGT-4	Growing2	Growing
GATCGCGCAAGAGGCT-3	Growing1	Growing
GATCGTATCCGAAGAG-1	Senescence1	RIS
GATGAAAGTGTCTGAT-4	Growing2	Growing
GATGAGGCACAACTGT-1	Senescence1	RIS
GATGCTATCCAATGGT-3	Growing1	Growing
GATTCAGCACATTCGA-1	Senescence1	RIS
GATTCAGGTAGCGCTC-1	Senescence1	RIS
GCAAACTCATACAGCT-4	Growing2	Growing
GCAAACTTCGTTTGCC-4	Growing2	Growing
GCAATCACATTTGCCC-4	Growing2	Growing
GCACATATCCTCTAGC-1	Senescence1	RIS
GCACTCTAGCACAGGT-1	Senescence1	RIS
GCACTCTTCCCATTAT-1	Senescence1	RIS
GCAGCCACATTAGCCA-4	Growing2	Growing
GCAGCCAGTTGGTGGA-1	Senescence1	RIS
GCAGTTATCGCCTGTT-4	Growing2	Growing
GCATACAAGTGTCTCA-3	Growing1	Growing
GCATACATCTTCCTTC-1	Senescence1	GFP
GCATGTAAGCTAAGAT-1	Senescence1	RIS
GCGACCATCCCAAGTA-1	Senescence1	RIS
GCGCAACAGCGAGAAA-3	Growing1	Growing
GCGCAGTGTACCGTTA-3	Growing1	Growing
GCGCAGTTCATCGCTC-4	Growing2	Growing
GCGCAGTTCCTGCCAT-4	Growing2	Growing
GCGCCAAGTGATAAGT-1	Senescence1	RIS
GCGCCAAGTGATGCCC-3	Growing1	Growing
GCGCGATCAAGTCATC-3	Growing1	Growing
GCGGGTTGTGCAACTT-1	Senescence1	RIS
GCTGCGATCTGCCAGG-1	Senescence1	RIS
GCTGCTTAGGGCATGT-4	Growing2	Growing
GCTGCTTGTTCGAATC-4	Growing2	Growing
GCTGCTTTCTAACCGA-4	Growing2	Growing
GCTGGGTTCGTTTATC-3	Growing1	Growing
GCTTCCAAGTGCCAGA-1	Senescence1	GFP
GCTTCCACACTGAAGG-1	Senescence1	RIS
GCTTCCAGTTCGTCTC-3	Growing1	Growing
GCTTGAAAGATGGCGT-1	Senescence1	RIS
GCTTGAAAGCTTCGCG-1	Senescence1	RIS
GGACAAGCAAATCCGT-1	Senescence1	RIS
GGACAAGCACACAGAG-4	Growing2	Growing
GGACAAGGTCTGGTCG-1	Senescence1	RIS
GGACATTTCGACCAGC-1	Senescence1	GFP
GGACGTCGTGAAATCA-1	Senescence1	RIS
GGATGTTAGTAGTGCG-3	Growing1	Growing
GGATGTTCAACTGCTA-1	Senescence1	RIS
GGATTACTCATAACCG-1	Senescence1	RIS
GGCAATTCACGTGAGA-1	Senescence1	RIS
GGCAATTGTTCCACGG-3	Growing1	Growing
GGCTCGAGTCACACGC-3	Growing1	Growing
GGCTCGAGTCTAGTGT-1	Senescence1	RIS
GGCTCGAGTGCCTGCA-1	Senescence1	RIS
GGCTCGATCACATGCA-1	Senescence1	RIS
GGCTCGATCTTTAGGG-1	Senescence1	RIS
GGCTGGTGTGGTACAG-1	Senescence1	RIS
GGCTGGTTCGCTTAGA-1	Senescence1	RIS
GGGAATGCACTCTGTC-3	Growing1	Growing
GGGAATGCAGCTATTG-4	Growing2	Growing
GGGACCTAGATACACA-4	Growing2	Growing
GGGAGATCAAGTTCTG-3	Growing1	Growing
GGGAGATCATATGCTG-1	Senescence1	GFP
GGGCACTAGTACGACG-1	Senescence1	RIS
GGGCATCCACACATGT-3	Growing1	Growing
GGGTTGCGTCAGGACA-1	Senescence1	RIS
GGTGAAGCAATCGGTT-1	Senescence1	RIS
GGTGTTATCACAAACC-1	Senescence1	RIS
GTAACTGAGAATAGGG-4	Growing2	Growing
GTAACTGAGTGTGAAT-1	Senescence1	RIS
GTAACTGGTAGCCTAT-1	Senescence1	RIS
GTAACTGGTCAATACC-3	Growing1	Growing
GTACGTAAGAGACTAT-1	Senescence1	RIS
GTACGTATCAGAGACG-3	Growing1	Growing
GTACTCCAGAGTCTGG-4	Growing2	Growing
GTACTTTAGGCGCTCT-1	Senescence1	RIS
GTACTTTGTTTGTTTC-3	Growing1	Growing
GTAGGCCCAACACGCC-1	Senescence1	RIS
GTAGGCCTCCTGCTTG-1	Senescence1	RIS
GTAGTCACATAACCTG-3	Growing1	Growing
GTAGTCAGTAGAGGAA-1	Senescence1	RIS
GTATCTTAGACTGTAA-4	Growing2	Growing
GTCACAATCAATACCG-3	Growing1	Growing
GTCACGGCATCGATGT-1	Senescence1	RIS
GTCTCGTCACACTGCG-1	Senescence1	RIS
GTCTTCGAGAAACGAG-1	Senescence1	RIS
GTGAAGGAGCACGCCT-3	Growing1	Growing
GTGAAGGCAAGCGTAG-3	Growing1	Growing
GTGCATATCCTGTACC-1	Senescence1	GFP
GTGCGGTAGAGCTTCT-4	Growing2	Growing
GTGCGGTAGTCTTGCA-4	Growing2	Growing
GTGCTTCTCTCTTATG-1	Senescence1	RIS
GTGGGTCAGACAAAGG-1	Senescence1	RIS
GTGGGTCCAATAAGCA-4	Growing2	Growing
GTTAAGCAGTGCCATT-1	Senescence1	RIS
GTTAAGCTCTTCAACT-4	Growing2	Growing
GTTACAGAGAAGGTTT-1	Senescence1	RIS
GTTCATTAGGCACATG-1	Senescence1	RIS
GTTCATTAGGCTAGAC-1	Senescence1	RIS
GTTCATTCAACTTGAC-1	Senescence1	RIS
GTTCATTTCAAGCCTA-4	Growing2	Growing
GTTCATTTCCTTTACA-1	Senescence1	RIS
GTTCGGGAGCGATGAC-4	Growing2	Growing
GTTCGGGGTAGCTCCG-4	Growing2	Growing
GTTCGGGTCTATGTGG-1	Senescence1	RIS
GTTCTCGCACTCGACG-1	Senescence1	RIS
TAAGAGATCTGTTTGT-4	Growing2	Growing
TACACGACAAGGACTG-1	Senescence1	RIS
TACCTATGTCCCGACA-1	Senescence1	GFP
TACGGATTCATCATTC-3	Growing1	Growing
TACTCATCACTGAAGG-1	Senescence1	RIS
TACTTACGTCATACTG-1	Senescence1	GFP
TACTTGTAGATGGCGT-3	Growing1	Growing
TAGACCAGTGCATCTA-1	Senescence1	RIS
TAGCCGGCAGTCGTGC-1	Senescence1	GFP
TAGGCATGTGCACCAC-3	Growing1	Growing
TAGGCATGTTACTGAC-1	Senescence1	RIS
TAGTTGGAGGCTATCT-1	Senescence1	RIS
TAGTTGGGTAAAGTCA-1	Senescence1	RIS
TATCAGGAGAAGGCCT-3	Growing1	Growing
TATCAGGTCGTCCGTT-1	Senescence1	RIS
TATCTCATCCGAATGT-1	Senescence1	RIS
TCAACGACATCGGGTC-3	Growing1	Growing
TCAATCTAGTAGCGGT-1	Senescence1	GFP
TCAATCTCAACTGCTA-1	Senescence1	RIS
TCAGATGAGTCTTGCA-1	Senescence1	RIS
TCAGATGCAGTATCTG-4	Growing2	Growing
TCAGCTCCAATGTTGC-1	Senescence1	RIS
TCAGCTCGTGCCTGGT-1	Senescence1	RIS
TCAGGATCATGCTAGT-1	Senescence1	RIS
TCAGGTAGTAATCGTC-3	Growing1	Growing
TCATTACAGGGTCGAT-3	Growing1	Growing
TCATTACTCCTGCAGG-3	Growing1	Growing
TCATTTGGTCATTAGC-3	Growing1	Growing
TCCACACCACCAACCG-1	Senescence1	RIS
TCGAGGCGTTCCTCCA-1	Senescence1	GFP
TCGCGAGAGCTGATAA-1	Senescence1	RIS
TCGCGAGTCGGACAAG-1	Senescence1	RIS
TCGCGTTCACATTAGC-3	Growing1	Growing
TCGGTAACAAGTCTGT-3	Growing1	Growing
TCGTACCGTAATAGCA-1	Senescence1	RIS
TCGTAGAGTTACAGAA-1	Senescence1	RIS
TCTCATACATCACGTA-3	Growing1	Growing
TCTCATAGTCTGCCAG-1	Senescence1	RIS
TCTCTAAAGACATAAC-3	Growing1	Growing
TCTTTCCAGGCAATTA-1	Senescence1	RIS
TCTTTCCGTTTAGGAA-1	Senescence1	RIS
TGACAACCAAACGTGG-1	Senescence1	RIS
TGACAACTCATTTGGG-3	Growing1	Growing
TGACGGCCAGTCACTA-4	Growing2	Growing
TGACTAGAGAAACGAG-3	Growing1	Growing
TGAGAGGTCCAGAGGA-1	Senescence1	RIS
TGAGCATGTTAGAACA-3	Growing1	Growing
TGCACCTAGGAGTTGC-1	Senescence1	RIS
TGCACCTCAGTAAGAT-4	Growing2	Growing
TGCCAAAGTCTCAACA-3	Growing1	Growing
TGCCCATTCAACGGGA-1	Senescence1	RIS
TGCCCATTCCGCAAGC-4	Growing2	Growing
TGCCCTACAGATCCAT-1	Senescence1	RIS
TGCCCTACAGGCGATA-1	Senescence1	RIS
TGCGGGTGTACCAGTT-1	Senescence1	RIS
TGCTACCAGAGCCTAG-1	Senescence1	RIS
TGGCTGGGTAAGGATT-4	Growing2	Growing
TGGGAAGCAGGGTATG-1	Senescence1	RIS
TGGGCGTAGTTGTCGT-3	Growing1	Growing
TGGTTCCCAGCCAGAA-1	Senescence1	RIS
TGGTTCCGTGACGCCT-1	Senescence1	RIS
TGGTTCCTCAACACGT-3	Growing1	Growing
TGTATTCAGCAGCCTC-3	Growing1	Growing
TGTATTCTCGAACTGT-1	Senescence1	RIS
TGTATTCTCGCAGGCT-1	Senescence1	RIS
TGTTCCGAGGTCATCT-1	Senescence1	RIS
TGTTCCGTCAACCAAC-3	Growing1	Growing
TTAACTCAGGATGGTC-1	Senescence1	RIS
TTATGCTGTTGGACCC-4	Growing2	Growing
TTATGCTTCGACAGCC-4	Growing2	Growing
TTATGCTTCTTTCCTC-3	Growing1	Growing
TTCCCAGCAAGCCGTC-1	Senescence1	RIS
TTCGAAGAGTCATCCA-1	Senescence1	RIS
TTCGAAGGTCCATCCT-3	Growing1	Growing
TTCGGTCTCGGTTAAC-3	Growing1	Growing
TTCTACATCTCGAGTA-1	Senescence1	RIS
TTCTCAATCAACGGGA-4	Growing2	Growing
TTCTCCTGTGCCTGTG-3	Growing1	Growing
TTCTTAGTCGGTCCGA-4	Growing2	Growing
TTGCCGTGTTTGTGTG-1	Senescence1	RIS
TTGCGTCAGTGGACGT-1	Senescence1	RIS
TTGCGTCTCTTCGGTC-1	Senescence1	RIS
TTGGAACTCGAGAGCA-1	Senescence1	RIS
TTGGAACTCTTAGAGC-1	Senescence1	RIS
TTGGCAACAAAGTGCG-1	Senescence1	GFP
TTGGCAATCGAGGTAG-4	Growing2	Growing
TTGTAGGAGCCAGTTT-3	Growing1	Growing
TTGTAGGGTTAAGACA-4	Growing2	Growing
TTTACTGGTTTAGGAA-3	Growing1	Growing
TTTCCTCCAGTATGCT-3	Growing1	Growing
TTTCCTCGTCAACATC-4	Growing2	Growing
TTTGCGCAGGCATTGG-1	Senescence1	RIS
TTTGCGCGTACGAAAT-4	Growing2	Growing
TTTGCGCGTCACTGGC-1	Senescence1	RIS
TTTGCGCGTCTGCGGT-1	Senescence1	RIS
TTTGTCAAGATGCCTT-1	Senescence1	RIS
TTTGTCACAATCTGCA-4	Growing2	Growing
TTTGTCACAGTCAGCC-4	Growing2	Growing
