cell	ID	clustser
EV_AAACGGGGTTAAGAAC	mVenus:EV	Secondary senescence, mVenus:EV
EV_AAACGGGTCTTGCATT	mVenus:EV	Secondary senescence, mVenus:EV
EV_AACCATGAGCTAGTGG	mVenus:EV	Secondary senescence, mVenus:EV
EV_AACCATGGTGTGAATA	mVenus:EV	Growing
EV_AACTTTCGTATAATGG	RIS from EV co-culture	OIS
EV_AAGCCGCTCACCAGGC	mVenus:EV	Growing
EV_AAGGAGCTCGGGAGTA	RIS from EV co-culture	OIS
EV_AAGGCAGCACACCGAC	mVenus:EV	Growing
EV_AAGTCTGTCAAACCGT	mVenus:EV	Growing
EV_AATCCAGCATTGCGGC	mVenus:EV	Growing
EV_ACACCAACAGCCTTTC	mVenus:EV	Growing
EV_ACACCCTAGTGGAGTC	mVenus:EV	Growing
EV_ACACCCTTCTCTTGAT	mVenus:EV	Secondary senescence, mVenus:EV
EV_ACAGCTACAGTGAGTG	mVenus:EV	Secondary senescence, mVenus:EV
EV_ACATCAGAGTGAATTG	mVenus:EV	Secondary senescence, mVenus:EV
EV_ACCCACTCAACACGCC	mVenus:EV	Secondary senescence, mVenus:EV
EV_ACCGTAAGTAGCTAAA	mVenus:EV	Growing
EV_ACCGTAAGTCTAGAGG	mVenus:EV	Secondary senescence, mVenus:EV
EV_ACCTTTAGTCTCTTAT	mVenus:EV	Growing
EV_ACGATACCACGGCCAT	mVenus:EV	Growing
EV_ACGATACTCTATCCTA	mVenus:EV	Secondary senescence, mVenus:EV
EV_ACGCCGACAGGCAGTA	mVenus:EV	Secondary senescence, mVenus:EV
EV_ACGGGTCCATATGGTC	mVenus:EV	Growing
EV_ACGTCAAGTACGACCC	mVenus:EV	OIS
EV_ACGTCAAGTGACAAAT	RIS from EV co-culture	OIS
EV_ACTATCTCAAGTAATG	mVenus:EV	Growing
EV_ACTATCTGTAAGTGTA	mVenus:EV	Growing
EV_ACTGAACAGCGAGAAA	mVenus:EV	Secondary senescence, mVenus:EV
EV_ACTGCTCTCCACGAAT	mVenus:EV	Secondary senescence, mVenus:EV
EV_ACTTACTAGGAGTCTG	mVenus:EV	Growing
EV_ACTTACTTCGCCGTGA	mVenus:EV	Growing
EV_ACTTGTTTCTCGCATC	mVenus:EV	Unassigned
EV_AGAATAGAGGTGATAT	mVenus:EV	Growing
EV_AGACGTTCAAATACAG	mVenus:EV	Growing
EV_AGAGCTTGTGTGAAAT	mVenus:EV	Secondary senescence, mVenus:EV
EV_AGAGTGGCAGCTCCGA	mVenus:EV	Growing
EV_AGCGTATCACGTAAGG	mVenus:EV	Secondary senescence, mVenus:EV
EV_AGCGTATCAGCTGTGC	mVenus:EV	Growing
EV_AGCGTATGTAGAGTGC	mVenus:EV	Growing
EV_AGCTCTCTCCGTTGTC	mVenus:EV	Secondary senescence, mVenus:EV
EV_AGGGAGTCAGCTGTGC	mVenus:EV	Growing
EV_AGGGATGCAAGACGTG	mVenus:EV	Growing
EV_AGGGTGAGTATTACCG	mVenus:EV	Secondary senescence, mVenus:EV
EV_AGGGTGATCCAACCAA	mVenus:EV	Growing
EV_AGGTCATCAGATGAGC	mVenus:EV	Growing
EV_AGTGTCACATATACGC	mVenus:EV	Growing
EV_ATCACGAAGTTTGCGT	mVenus:EV	Growing
EV_ATCACGAGTTTGACTG	mVenus:EV	Growing
EV_ATCTACTGTATATCCG	mVenus:EV	Unassigned
EV_ATCTGCCCATGCGCAC	mVenus:EV	Growing
EV_ATGAGGGGTGTGGTTT	mVenus:EV	Secondary senescence, mVenus:EV
EV_ATTGGACCACTCTGTC	mVenus:EV	Secondary senescence, mVenus:EV
EV_CAACCTCTCGGCATCG	mVenus:EV	Secondary senescence, mVenus:EV
EV_CAACTAGAGGAGTAGA	mVenus:EV	Growing
EV_CAAGGCCAGTTACCCA	mVenus:EV	Growing
EV_CAAGTTGTCAAGATCC	mVenus:EV	Growing
EV_CACACTCCATGCTAGT	mVenus:EV	Growing
EV_CACAGTAGTCGAAAGC	mVenus:EV	Growing
EV_CACAGTATCTTGTATC	mVenus:EV	Growing
EV_CACCACTGTCTCGTTC	mVenus:EV	Growing
EV_CAGAGAGCATTTCAGG	mVenus:EV	Growing
EV_CAGAGAGGTGATAAGT	mVenus:EV	Growing
EV_CAGCAGCCAAGTACCT	mVenus:EV	Secondary senescence, mVenus:EV
EV_CAGCATAAGCGTGAAC	mVenus:EV	Growing
EV_CAGCATACACTGTTAG	mVenus:EV	Secondary senescence, mVenus:EV
EV_CAGCCGATCACCTTAT	mVenus:EV	Growing
EV_CAGTAACTCTTTACGT	mVenus:EV	Secondary senescence, mVenus:EV
EV_CATATGGAGTCAAGCG	mVenus:EV	Growing
EV_CATATGGGTACCGTAT	mVenus:EV	Growing
EV_CATATTCAGCACACAG	mVenus:EV	Secondary senescence, mVenus:EV
EV_CATCAAGCAAGTCATC	mVenus:EV	Growing
EV_CATCAGATCTGCCCTA	mVenus:EV	Secondary senescence, mVenus:EV
EV_CATCGAACATACGCCG	mVenus:EV	Growing
EV_CATGCCTGTCTGCAAT	RIS from EV co-culture	OIS
EV_CATGCCTTCTGCGACG	mVenus:EV	Growing
EV_CCAATCCGTTCAGTAC	mVenus:EV	Secondary senescence, mVenus:EV
EV_CCACTACCAGCATACT	mVenus:EV	Growing
EV_CCATGTCTCTGGGCCA	mVenus:EV	Growing
EV_CCCAGTTTCTGGTTCC	mVenus:EV	Secondary senescence, mVenus:EV
EV_CCCTCCTGTCTAGTGT	mVenus:EV	Secondary senescence, mVenus:EV
EV_CCGGGATCACGAAATA	mVenus:EV	Secondary senescence, mVenus:EV
EV_CCTAAAGCATTTCACT	mVenus:EV	Secondary senescence, mVenus:EV
EV_CCTACACCATGCAATC	mVenus:EV	Secondary senescence, mVenus:EV
EV_CCTATTAAGCCCAGCT	mVenus:EV	Growing
EV_CCTCAGTAGGAATCGC	mVenus:EV	Growing
EV_CCTCTGACACCCAGTG	mVenus:EV	Secondary senescence, mVenus:EV
EV_CGAACATCAGTTCCCT	mVenus:EV	Secondary senescence, mVenus:EV
EV_CGAATGTTCTCTGAGA	mVenus:EV	OIS
EV_CGAGCACCAGCTGGCT	mVenus:EV	Growing
EV_CGAGCACTCCCGGATG	mVenus:EV	Growing
EV_CGAGCACTCCGCGGTA	mVenus:EV	Secondary senescence, mVenus:EV
EV_CGATCGGGTCCGAAGA	mVenus:EV	Secondary senescence, mVenus:EV
EV_CGATGTACAAATACAG	mVenus:EV	Secondary senescence, mVenus:EV
EV_CGATTGAAGCGAAGGG	mVenus:EV	Secondary senescence, mVenus:EV
EV_CGCGGTAAGAGTACCG	mVenus:EV	Secondary senescence, mVenus:EV
EV_CGCGGTAAGCTAGTGG	mVenus:EV	Secondary senescence, mVenus:EV
EV_CGCGGTAGTTAGATGA	mVenus:EV	Secondary senescence, mVenus:EV
EV_CGCGTTTCAGGATCGA	mVenus:EV	Growing
EV_CGCTATCAGGACCACA	mVenus:EV	Secondary senescence, mVenus:EV
EV_CGCTGGAAGGAGTCTG	RIS from EV co-culture	OIS
EV_CGGACTGAGAAGGCCT	mVenus:EV	Growing
EV_CGGAGTCGTTGTTTGG	mVenus:EV	Growing
EV_CGGCTAGCAACTGCTA	mVenus:EV	Growing
EV_CGGCTAGCAAGGTTCT	mVenus:EV	Growing
EV_CGGTTAATCTAACTCT	mVenus:EV	Secondary senescence, mVenus:EV
EV_CGTAGCGCATCATCCC	mVenus:EV	Growing
EV_CGTCAGGCAGCATGAG	mVenus:EV	Growing
EV_CGTCAGGGTGGAAAGA	mVenus:EV	Growing
EV_CGTCTACCATTAGGCT	mVenus:EV	Secondary senescence, mVenus:EV
EV_CGTTAGACAGGCTCAC	RIS from EV co-culture	OIS
EV_CTACATTCATTTGCTT	mVenus:EV	Secondary senescence, mVenus:EV
EV_CTACATTTCAGTTAGC	mVenus:EV	Growing
EV_CTCACACCATCGATTG	mVenus:EV	Growing
EV_CTCCTAGCAAGCCTAT	mVenus:EV	Growing
EV_CTCCTAGGTAAGTGTA	mVenus:EV	Growing
EV_CTCCTAGTCAGTGCAT	mVenus:EV	Growing
EV_CTCGTACGTTAAAGTG	mVenus:EV	Growing
EV_CTCTGGTAGCTCAACT	mVenus:EV	Secondary senescence, mVenus:EV
EV_CTCTGGTGTCGCGTGT	mVenus:EV	Growing
EV_CTGAAGTAGACGCAAC	mVenus:EV	Secondary senescence, mVenus:EV
EV_CTGAAGTTCGCGATCG	mVenus:EV	Secondary senescence, mVenus:EV
EV_CTGCCTATCAGGCAAG	mVenus:EV	Growing
EV_CTGCGGATCATTGCCC	mVenus:EV	Growing
EV_CTGCTGTCATCCTTGC	mVenus:EV	Secondary senescence, mVenus:EV
EV_CTTACCGGTTTACTCT	mVenus:EV	Growing
EV_CTTACCGTCCCAAGAT	mVenus:EV	Secondary senescence, mVenus:EV
EV_CTTCTCTTCTTGTTTG	mVenus:EV	Growing
EV_CTTGGCTAGCTGCGAA	mVenus:EV	Secondary senescence, mVenus:EV
EV_CTTGGCTAGGCATGTG	RIS from EV co-culture	OIS
EV_GAAACTCAGGACATTA	mVenus:EV	Growing
EV_GAACCTAAGAACTGTA	mVenus:EV	Growing
EV_GAAGCAGGTCCAACTA	mVenus:EV	Growing
EV_GAATAAGTCGCCTGAG	mVenus:EV	Secondary senescence, mVenus:EV
EV_GACGCGTTCCGCGTTT	mVenus:EV	Growing
EV_GACGGCTCAGGTGGAT	mVenus:EV	Growing
EV_GACTAACGTTTGTTTC	mVenus:EV	Growing
EV_GAGTCCGGTCTGGTCG	mVenus:EV	Growing
EV_GATCGATCACCATGTA	mVenus:EV	Growing
EV_GATCGTACAAGTACCT	mVenus:EV	Growing
EV_GATCTAGTCAACACCA	mVenus:EV	Growing
EV_GATGAGGCATCGGACC	mVenus:EV	Secondary senescence, mVenus:EV
EV_GATGCTAAGGCAGGTT	mVenus:EV	Unassigned
EV_GATGCTACAGTTCCCT	mVenus:EV	Secondary senescence, mVenus:EV
EV_GATGCTAGTAACGTTC	mVenus:EV	Secondary senescence, mVenus:EV
EV_GCACTCTAGTGTACGG	mVenus:EV	Growing
EV_GCACTCTCACAGGTTT	mVenus:EV	Secondary senescence, mVenus:EV
EV_GCACTCTGTAAGTTCC	mVenus:EV	Growing
EV_GCAGTTAAGACTACAA	mVenus:EV	Secondary senescence, mVenus:EV
EV_GCATACAGTGATGATA	mVenus:EV	Secondary senescence, mVenus:EV
EV_GCATACATCCCTAATT	mVenus:EV	Growing
EV_GCATGATAGATATGGT	mVenus:EV	Growing
EV_GCCTCTACAACACCCG	mVenus:EV	Growing
EV_GCGCAGTCACCCATGG	mVenus:EV	Growing
EV_GCTCTGTAGCTAGCCC	mVenus:EV	Growing
EV_GCTCTGTCAAGTTAAG	mVenus:EV	Growing
EV_GCTGCGACATGCAATC	mVenus:EV	Secondary senescence, mVenus:EV
EV_GCTTCCAAGCTGTTCA	mVenus:EV	Secondary senescence, mVenus:EV
EV_GCTTCCATCAGTTAGC	mVenus:EV	Secondary senescence, mVenus:EV
EV_GGAAAGCGTCTCAACA	mVenus:EV	Secondary senescence, mVenus:EV
EV_GGAACTTGTCCGCTGA	mVenus:EV	Secondary senescence, mVenus:EV
EV_GGACAGATCGGAATCT	mVenus:EV	Secondary senescence, mVenus:EV
EV_GGATGTTCAAGCTGGA	mVenus:EV	Growing
EV_GGATGTTGTCATTAGC	mVenus:EV	Growing
EV_GGATTACGTAACGTTC	mVenus:EV	Growing
EV_GGCTCGATCTACCTGC	mVenus:EV	Growing
EV_GGCTGGTGTTCCCGAG	RIS from EV co-culture	OIS
EV_GGGACCTGTGTAATGA	mVenus:EV	Secondary senescence, mVenus:EV
EV_GGGCACTCATCGGAAG	mVenus:EV	Growing
EV_GGGCATCAGGGATGGG	mVenus:EV	Growing
EV_GGGTCTGCACCTCGTT	mVenus:EV	Secondary senescence, mVenus:EV
EV_GTAACGTAGGACTGGT	RIS from EV co-culture	OIS
EV_GTAACGTGTTACGACT	mVenus:EV	Growing
EV_GTAACTGAGATGCGAC	mVenus:EV	Growing
EV_GTAACTGAGTCATGCT	mVenus:EV	Secondary senescence, mVenus:EV
EV_GTACTTTTCGCCTGTT	mVenus:EV	Growing
EV_GTCAAGTCAATGACCT	RIS from EV co-culture	OIS
EV_GTCACAATCCTAAGTG	mVenus:EV	Secondary senescence, mVenus:EV
EV_GTCATTTTCTGGCGTG	mVenus:EV	Growing
EV_GTCGGGTGTCGTCTTC	mVenus:EV	Growing
EV_GTCGTAAAGGTGCACA	mVenus:EV	Secondary senescence, mVenus:EV
EV_GTCGTAACATACCATG	mVenus:EV	Secondary senescence, mVenus:EV
EV_GTCTCGTCACCCAGTG	mVenus:EV	Growing
EV_GTGAAGGCACGGCCAT	mVenus:EV	Secondary senescence, mVenus:EV
EV_GTTCGGGAGAAGGACA	mVenus:EV	Growing
EV_GTTCTCGAGCCGATTT	mVenus:EV	Secondary senescence, mVenus:EV
EV_GTTTCTAAGAACAATC	mVenus:EV	Unassigned
EV_GTTTCTAGTGTGACCC	mVenus:EV	Secondary senescence, mVenus:EV
EV_TAAGCGTCAGACAGGT	mVenus:EV	Growing
EV_TAAGTGCAGGAATCGC	mVenus:EV	Growing
EV_TACAGTGTCAACCAAC	mVenus:EV	Growing
EV_TACCTATTCTTGTCAT	mVenus:EV	Growing
EV_TACGGATAGTGCGTGA	RIS from EV co-culture	OIS
EV_TACGGTATCAACACGT	mVenus:EV	Unassigned
EV_TAGAGCTGTGCAGGTA	mVenus:EV	Growing
EV_TAGGCATAGTACGATA	mVenus:EV	Growing
EV_TATCAGGCAAGTCATC	mVenus:EV	Unassigned
EV_TCAATCTCAGCCAGAA	mVenus:EV	Growing
EV_TCACGAAGTACGAAAT	mVenus:EV	Growing
EV_TCAGGATCAAACAACA	mVenus:EV	Growing
EV_TCAGGTAGTGCAACTT	mVenus:EV	Growing
EV_TCATTTGAGAATAGGG	mVenus:EV	Secondary senescence, mVenus:EV
EV_TCCCGATAGAGATGAG	mVenus:EV	Growing
EV_TCGTACCTCACCATAG	mVenus:EV	Growing
EV_TCGTAGAGTCGGCACT	mVenus:EV	Growing
EV_TCTATTGAGGCCGAAT	mVenus:EV	Growing
EV_TCTCTAAGTGTTTGGT	mVenus:EV	Growing
EV_TCTTCGGCACAGCCCA	mVenus:EV	Growing
EV_TGACAACAGACCGGAT	mVenus:EV	Secondary senescence, mVenus:EV
EV_TGAGAGGGTTGATTGC	mVenus:EV	Secondary senescence, mVenus:EV
EV_TGAGCCGGTCATTAGC	mVenus:EV	Growing
EV_TGATTTCGTTCTGAAC	mVenus:EV	Growing
EV_TGCACCTTCACCTTAT	mVenus:EV	Growing
EV_TGCCCTATCTCCAACC	mVenus:EV	Unassigned
EV_TGCGCAGGTAGCTTGT	mVenus:EV	Growing
EV_TGCGCAGTCTGTTTGT	RIS from EV co-culture	OIS
EV_TGCGTGGCACTGTTAG	mVenus:EV	Secondary senescence, mVenus:EV
EV_TGCGTGGTCCGGCACA	mVenus:EV	Growing
EV_TGCTACCAGAGTGACC	mVenus:EV	Secondary senescence, mVenus:EV
EV_TGCTGCTAGGTGCACA	mVenus:EV	Growing
EV_TGGGAAGTCGGCGCAT	RIS from EV co-culture	OIS
EV_TGGTTAGGTAATCACC	RIS from EV co-culture	OIS
EV_TGTATTCGTGAACCTT	mVenus:EV	Unassigned
EV_TGTCCCATCTACCAGA	mVenus:EV	Secondary senescence, mVenus:EV
EV_TGTGGTACATGGATGG	RIS from EV co-culture	OIS
EV_TGTGGTATCCTATTCA	mVenus:EV	Secondary senescence, mVenus:EV
EV_TGTGTTTAGAACAACT	mVenus:EV	Growing
EV_TGTGTTTTCGCGCCAA	mVenus:EV	Secondary senescence, mVenus:EV
EV_TTAGGACAGATACACA	mVenus:EV	Secondary senescence, mVenus:EV
EV_TTCGAAGGTAATCACC	mVenus:EV	Growing
EV_TTCTCCTGTCTCTTTA	mVenus:EV	Growing
EV_TTGACTTGTTGGACCC	mVenus:EV	Growing
EV_TTGCCGTCAAGTCATC	mVenus:EV	Growing
EV_TTGCCGTTCACCGGGT	mVenus:EV	Secondary senescence, mVenus:EV
EV_TTGCCGTTCAGGTAAA	mVenus:EV	Growing
dnMAML1_AAACCTGTCTGCGGCA	mVenus:dnMAML1	Growing
dnMAML1_AAACGGGTCACTGGGC	mVenus:dnMAML1	Growing
dnMAML1_AAAGATGGTTGGACCC	mVenus:dnMAML1	Growing
dnMAML1_AAAGATGTCGATCCCT	mVenus:dnMAML1	Growing
dnMAML1_AAAGCAAGTGACGGTA	mVenus:dnMAML1	Growing
dnMAML1_AAAGTAGGTCCGTGAC	mVenus:dnMAML1	Growing
dnMAML1_AAATGCCTCAAGCCTA	mVenus:dnMAML1	Growing
dnMAML1_AAATGCCTCTCACATT	mVenus:dnMAML1	Growing
dnMAML1_AACACGTGTTGCCTCT	mVenus:dnMAML1	Growing
dnMAML1_AACCATGAGACCTAGG	mVenus:dnMAML1	Growing
dnMAML1_AACTGGTAGCTAACTC	mVenus:dnMAML1	Secondary senescence, mVenus:dnMAML1
dnMAML1_AAGCCGCGTATATCCG	mVenus:dnMAML1	Growing
dnMAML1_AAGGCAGTCCGAATGT	mVenus:dnMAML1	Secondary senescence, mVenus:dnMAML1
dnMAML1_AAGTCTGGTTGGTTTG	mVenus:dnMAML1	Secondary senescence, mVenus:dnMAML1
dnMAML1_AATCGGTTCCCAAGTA	mVenus:dnMAML1	Secondary senescence, mVenus:dnMAML1
dnMAML1_ACACCCTGTCTAAACC	mVenus:dnMAML1	Growing
dnMAML1_ACACCGGCAGCAGTTT	mVenus:dnMAML1	Growing
dnMAML1_ACATACGAGTGTCTCA	mVenus:dnMAML1	Growing
dnMAML1_ACATACGTCTCCTATA	mVenus:dnMAML1	Growing
dnMAML1_ACATCAGTCCAAGCCG	mVenus:dnMAML1	Growing
dnMAML1_ACCCACTCATGACATC	mVenus:dnMAML1	Growing
dnMAML1_ACCCACTTCTCTTGAT	mVenus:dnMAML1	Growing
dnMAML1_ACGAGCCAGTGAAGTT	mVenus:dnMAML1	Secondary senescence, mVenus:dnMAML1
dnMAML1_ACGAGGACAAGCTGAG	mVenus:dnMAML1	Growing
dnMAML1_ACGAGGACACGCATCG	mVenus:dnMAML1	Growing
dnMAML1_ACGATACCATCCGTGG	mVenus:dnMAML1	Secondary senescence, mVenus:dnMAML1
dnMAML1_ACGATGTCACATCCAA	mVenus:dnMAML1	Growing
dnMAML1_ACGATGTGTCCCTACT	mVenus:dnMAML1	Growing
dnMAML1_ACGCAGCAGGAGTTTA	mVenus:dnMAML1	Growing
dnMAML1_ACGCAGCCAAGAAAGG	mVenus:dnMAML1	Secondary senescence, mVenus:dnMAML1
dnMAML1_ACGCCGACATGTCGAT	mVenus:dnMAML1	Growing
dnMAML1_ACGGAGATCCGCAGTG	mVenus:dnMAML1	Secondary senescence, mVenus:dnMAML1
dnMAML1_ACGGCCATCGCCCTTA	mVenus:dnMAML1	Growing
dnMAML1_ACTGAACAGAGCAATT	mVenus:dnMAML1	Secondary senescence, mVenus:dnMAML1
dnMAML1_ACTGATGCATTCTTAC	mVenus:dnMAML1	OIS
dnMAML1_ACTGCTCAGTGGCACA	mVenus:dnMAML1	Growing
dnMAML1_ACTGCTCTCATATCGG	mVenus:dnMAML1	Growing
dnMAML1_ACTGCTCTCGTTTGCC	mVenus:dnMAML1	Growing
dnMAML1_ACTTGTTCAGGAACGT	mVenus:dnMAML1	Secondary senescence, mVenus:dnMAML1
dnMAML1_ACTTGTTTCTGATTCT	mVenus:dnMAML1	Secondary senescence, mVenus:dnMAML1
dnMAML1_AGAATAGTCAGTACGT	mVenus:dnMAML1	Secondary senescence, mVenus:dnMAML1
dnMAML1_AGAATAGTCGTCACGG	mVenus:dnMAML1	Growing
dnMAML1_AGAGCGATCCCAAGAT	mVenus:dnMAML1	Secondary senescence, mVenus:dnMAML1
dnMAML1_AGAGCTTTCCTGCCAT	mVenus:dnMAML1	Growing
dnMAML1_AGAGTGGCATTAGCCA	mVenus:dnMAML1	Growing
dnMAML1_AGATCTGGTCACCCAG	mVenus:dnMAML1	Growing
dnMAML1_AGATTGCAGACGACGT	mVenus:dnMAML1	Growing
dnMAML1_AGCAGCCCATTCTCAT	mVenus:dnMAML1	Growing
dnMAML1_AGCATACCATTGGTAC	mVenus:dnMAML1	Secondary senescence, mVenus:dnMAML1
dnMAML1_AGCGTATGTCTTCAAG	mVenus:dnMAML1	Secondary senescence, mVenus:dnMAML1
dnMAML1_AGCTCCTAGCTCCTCT	mVenus:dnMAML1	Growing
dnMAML1_AGGCCACAGACGACGT	mVenus:dnMAML1	Growing
dnMAML1_AGGCCGTTCGTGGGAA	mVenus:dnMAML1	Growing
dnMAML1_AGGGATGAGCCCAGCT	mVenus:dnMAML1	Growing
dnMAML1_AGGGATGCAGTGGAGT	mVenus:dnMAML1	Growing
dnMAML1_AGGGATGGTATAATGG	mVenus:dnMAML1	Growing
dnMAML1_AGGGTGAAGATGGCGT	RIS from dnMAML1 co-culture	OIS
dnMAML1_AGGTCATTCGTCCAGG	mVenus:dnMAML1	Growing
dnMAML1_AGTAGTCAGGCAAAGA	mVenus:dnMAML1	Growing
dnMAML1_AGTAGTCTCCCTGACT	mVenus:dnMAML1	Secondary senescence, mVenus:dnMAML1
dnMAML1_AGTCTTTTCACGCATA	mVenus:dnMAML1	Growing
dnMAML1_AGTGAGGCAGCTCGAC	mVenus:dnMAML1	Growing
dnMAML1_AGTGGGATCACATGCA	mVenus:dnMAML1	Growing
dnMAML1_AGTGGGATCGCCTGTT	mVenus:dnMAML1	Growing
dnMAML1_AGTGTCATCTTATCTG	mVenus:dnMAML1	Secondary senescence, mVenus:dnMAML1
dnMAML1_AGTTGGTCACCAGGTC	mVenus:dnMAML1	Growing
dnMAML1_ATAACGCAGAGCTGGT	mVenus:dnMAML1	Growing
dnMAML1_ATAACGCGTGCACTTA	mVenus:dnMAML1	Growing
dnMAML1_ATCACGATCTTGCAAG	mVenus:dnMAML1	Growing
dnMAML1_ATCGAGTAGACAAGCC	mVenus:dnMAML1	Growing
dnMAML1_ATCTGCCCATCTGGTA	mVenus:dnMAML1	Growing
dnMAML1_ATGCGATAGTCGCCGT	mVenus:dnMAML1	Growing
dnMAML1_ATGCGATTCTTGTACT	mVenus:dnMAML1	Growing
dnMAML1_ATGGGAGTCCTCATTA	mVenus:dnMAML1	Growing
dnMAML1_ATGTGTGAGTCGAGTG	mVenus:dnMAML1	Secondary senescence, mVenus:dnMAML1
dnMAML1_ATTCTACCAGTGACAG	mVenus:dnMAML1	Growing
dnMAML1_ATTGGACCACGGACAA	mVenus:dnMAML1	Secondary senescence, mVenus:dnMAML1
dnMAML1_CAACCTCAGAAACGCC	mVenus:dnMAML1	Growing
dnMAML1_CAACCTCAGTGACATA	mVenus:dnMAML1	Secondary senescence, mVenus:dnMAML1
dnMAML1_CAACCTCCAGCAGTTT	mVenus:dnMAML1	OIS
dnMAML1_CAACCTCCAGTCAGAG	mVenus:dnMAML1	Growing
dnMAML1_CAAGATCTCACTGGGC	mVenus:dnMAML1	Growing
dnMAML1_CAAGATCTCCGCTGTT	mVenus:dnMAML1	Unassigned
dnMAML1_CACAAACCAGCTCCGA	mVenus:dnMAML1	Secondary senescence, mVenus:dnMAML1
dnMAML1_CACATTTTCCACGACG	mVenus:dnMAML1	Growing
dnMAML1_CACCACTGTTCAGTAC	mVenus:dnMAML1	Growing
dnMAML1_CACCACTTCGAATGGG	mVenus:dnMAML1	Secondary senescence, mVenus:dnMAML1
dnMAML1_CACCAGGGTAAATGTG	mVenus:dnMAML1	Growing
dnMAML1_CACTCCACATTGGCGC	mVenus:dnMAML1	Growing
dnMAML1_CAGAATCTCCGAACGC	mVenus:dnMAML1	Secondary senescence, mVenus:dnMAML1
dnMAML1_CAGATCACAGCTTAAC	mVenus:dnMAML1	Growing
dnMAML1_CAGCAGCGTTACCAGT	mVenus:dnMAML1	Growing
dnMAML1_CAGCATACAAGCGATG	mVenus:dnMAML1	Growing
dnMAML1_CAGCTAAGTCAAGCGA	mVenus:dnMAML1	Secondary senescence, mVenus:dnMAML1
dnMAML1_CAGGTGCCAGACAGGT	mVenus:dnMAML1	Growing
dnMAML1_CAGTAACCAGGCTCAC	mVenus:dnMAML1	Secondary senescence, mVenus:dnMAML1
dnMAML1_CAGTAACTCTCGTTTA	mVenus:dnMAML1	Growing
dnMAML1_CAGTCCTAGCCCAATT	mVenus:dnMAML1	Growing
dnMAML1_CAGTCCTAGGATATAC	mVenus:dnMAML1	Growing
dnMAML1_CAGTCCTCAACGCACC	mVenus:dnMAML1	Growing
dnMAML1_CATATGGTCTAACTTC	mVenus:dnMAML1	Growing
dnMAML1_CATCAAGTCGCTAGCG	mVenus:dnMAML1	Growing
dnMAML1_CATCAGATCTGGCGTG	mVenus:dnMAML1	Secondary senescence, mVenus:dnMAML1
dnMAML1_CATCCACCAGTTTACG	mVenus:dnMAML1	Growing
dnMAML1_CATCCACGTTAAGTAG	mVenus:dnMAML1	Growing
dnMAML1_CATCGAAAGCTAAACA	mVenus:dnMAML1	Growing
dnMAML1_CATCGAAGTGCGAAAC	mVenus:dnMAML1	Growing
dnMAML1_CATGGCGCATGCATGT	mVenus:dnMAML1	Secondary senescence, mVenus:dnMAML1
dnMAML1_CATGGCGTCAGCAACT	mVenus:dnMAML1	Growing
dnMAML1_CATGGCGTCGCCTGAG	mVenus:dnMAML1	Growing
dnMAML1_CATTCGCAGTGTCCCG	mVenus:dnMAML1	Growing
dnMAML1_CCAATCCAGCGATATA	mVenus:dnMAML1	Secondary senescence, mVenus:dnMAML1
dnMAML1_CCAATCCTCCAGATCA	mVenus:dnMAML1	Growing
dnMAML1_CCACCTAGTTGCGCAC	mVenus:dnMAML1	Growing
dnMAML1_CCACTACAGACAGAGA	mVenus:dnMAML1	Growing
dnMAML1_CCCAATCGTCTAGCCG	mVenus:dnMAML1	Growing
dnMAML1_CCCAGTTCATGTAGTC	mVenus:dnMAML1	Growing
dnMAML1_CCCATACGTAATCACC	mVenus:dnMAML1	Growing
dnMAML1_CCCTCCTAGCCTCGTG	mVenus:dnMAML1	Growing
dnMAML1_CCGGGATCATGCATGT	mVenus:dnMAML1	Secondary senescence, mVenus:dnMAML1
dnMAML1_CCGGTAGGTCCATCCT	mVenus:dnMAML1	Growing
dnMAML1_CCGGTAGGTGAAGGCT	mVenus:dnMAML1	Growing
dnMAML1_CCGTACTGTCTAGTCA	mVenus:dnMAML1	Growing
dnMAML1_CCGTTCAAGATCGGGT	mVenus:dnMAML1	Secondary senescence, mVenus:dnMAML1
dnMAML1_CCTACACCAGTCACTA	mVenus:dnMAML1	Growing
dnMAML1_CCTCAGTAGCCACTAT	mVenus:dnMAML1	Secondary senescence, mVenus:dnMAML1
dnMAML1_CCTCAGTCATCACCCT	mVenus:dnMAML1	Growing
dnMAML1_CCTCAGTTCGCACTCT	mVenus:dnMAML1	Growing
dnMAML1_CCTTACGTCGATGAGG	mVenus:dnMAML1	Growing
dnMAML1_CCTTCCCCATCATCCC	mVenus:dnMAML1	Growing
dnMAML1_CGACTTCTCCGAATGT	mVenus:dnMAML1	Growing
dnMAML1_CGAGAAGGTTATCGGT	mVenus:dnMAML1	Secondary senescence, mVenus:dnMAML1
dnMAML1_CGAGCACTCTAACTTC	mVenus:dnMAML1	Growing
dnMAML1_CGATCGGCAGTTCATG	mVenus:dnMAML1	Secondary senescence, mVenus:dnMAML1
dnMAML1_CGATCGGTCCTTTCTC	mVenus:dnMAML1	Secondary senescence, mVenus:dnMAML1
dnMAML1_CGATGGCGTTTGGGCC	mVenus:dnMAML1	Growing
dnMAML1_CGATGTACAGCCTTGG	mVenus:dnMAML1	Secondary senescence, mVenus:dnMAML1
dnMAML1_CGATTGAAGTGCCAGA	mVenus:dnMAML1	Growing
dnMAML1_CGATTGACAAGTTAAG	mVenus:dnMAML1	Unassigned
dnMAML1_CGGACGTGTCTAGTGT	mVenus:dnMAML1	Secondary senescence, mVenus:dnMAML1
dnMAML1_CGGAGCTTCTCTTGAT	mVenus:dnMAML1	Growing
dnMAML1_CGGTTAACATGTAAGA	mVenus:dnMAML1	Growing
dnMAML1_CGTAGCGAGAGCCCAA	mVenus:dnMAML1	Growing
dnMAML1_CGTCACTTCCTTTCGG	mVenus:dnMAML1	Secondary senescence, mVenus:dnMAML1
dnMAML1_CGTCAGGGTACATCCA	mVenus:dnMAML1	Growing
dnMAML1_CGTTGGGCAGGGTATG	mVenus:dnMAML1	Growing
dnMAML1_CTAACTTCAACCGCCA	mVenus:dnMAML1	Growing
dnMAML1_CTAAGACTCAGGATCT	mVenus:dnMAML1	Growing
dnMAML1_CTACACCGTCTCTTTA	mVenus:dnMAML1	Secondary senescence, mVenus:dnMAML1
dnMAML1_CTACATTTCCTTAATC	mVenus:dnMAML1	Growing
dnMAML1_CTACCCATCCAAACAC	mVenus:dnMAML1	Growing
dnMAML1_CTAGCCTTCCACGCAG	mVenus:dnMAML1	Growing
dnMAML1_CTAGTGAAGGGTGTGT	mVenus:dnMAML1	Growing
dnMAML1_CTCACACCACGGACAA	mVenus:dnMAML1	Growing
dnMAML1_CTCAGAAAGCTAGTTC	mVenus:dnMAML1	Growing
dnMAML1_CTCATTACATGAAGTA	mVenus:dnMAML1	Growing
dnMAML1_CTCGGAGAGCTAGTTC	mVenus:dnMAML1	Growing
dnMAML1_CTCGGGACACTTGGAT	mVenus:dnMAML1	Growing
dnMAML1_CTCGTACAGAGATGAG	mVenus:dnMAML1	Growing
dnMAML1_CTCGTCAAGGGAACGG	mVenus:dnMAML1	Growing
dnMAML1_CTCTGGTAGGGTTTCT	mVenus:dnMAML1	Secondary senescence, mVenus:dnMAML1
dnMAML1_CTGATAGTCTGAGTGT	mVenus:dnMAML1	Growing
dnMAML1_CTGATCCCATTACGAC	mVenus:dnMAML1	Secondary senescence, mVenus:dnMAML1
dnMAML1_CTGATCCTCTGTCTAT	mVenus:dnMAML1	Growing
dnMAML1_CTGTGCTAGTGACTCT	mVenus:dnMAML1	Growing
dnMAML1_CTGTTTACATCGGACC	mVenus:dnMAML1	Growing
dnMAML1_CTTACCGAGGCTAGGT	mVenus:dnMAML1	Growing
dnMAML1_CTTCTCTGTCGTCTTC	mVenus:dnMAML1	Growing
dnMAML1_GAAATGACACCACCAG	mVenus:dnMAML1	Growing
dnMAML1_GAACATCTCATGTGGT	mVenus:dnMAML1	Growing
dnMAML1_GAACCTAGTTTGTGTG	mVenus:dnMAML1	Growing
dnMAML1_GAAGCAGGTTTGACTG	mVenus:dnMAML1	Growing
dnMAML1_GAATGAAAGAGATGAG	mVenus:dnMAML1	Secondary senescence, mVenus:dnMAML1
dnMAML1_GAATGAACAGACAGGT	mVenus:dnMAML1	Growing
dnMAML1_GAATGAACAGACGCTC	mVenus:dnMAML1	Unassigned
dnMAML1_GACACGCCAATAAGCA	mVenus:dnMAML1	Secondary senescence, mVenus:dnMAML1
dnMAML1_GACAGAGGTGCCTGGT	mVenus:dnMAML1	Growing
dnMAML1_GACCTGGGTGCGATAG	mVenus:dnMAML1	Growing
dnMAML1_GACTAACAGCAGCCTC	mVenus:dnMAML1	Growing
dnMAML1_GAGCAGAAGGTGTTAA	mVenus:dnMAML1	Secondary senescence, mVenus:dnMAML1
dnMAML1_GAGGTGACACAGGAGT	mVenus:dnMAML1	Secondary senescence, mVenus:dnMAML1
dnMAML1_GAGTCCGAGACTTTCG	mVenus:dnMAML1	Growing
dnMAML1_GAGTCCGTCATGGTCA	mVenus:dnMAML1	Growing
dnMAML1_GATCGATAGTGTTAGA	mVenus:dnMAML1	Growing
dnMAML1_GATCGCGCATCGGTTA	mVenus:dnMAML1	Growing
dnMAML1_GATCTAGGTCAGCTAT	mVenus:dnMAML1	OIS
dnMAML1_GATGAGGAGCCGTCGT	mVenus:dnMAML1	Growing
dnMAML1_GATGAGGCAATGTAAG	mVenus:dnMAML1	Secondary senescence, mVenus:dnMAML1
dnMAML1_GATTCAGGTTAAAGTG	mVenus:dnMAML1	Secondary senescence, mVenus:dnMAML1
dnMAML1_GCAAACTAGGAGCGAG	mVenus:dnMAML1	Secondary senescence, mVenus:dnMAML1
dnMAML1_GCACTCTTCACAGTAC	mVenus:dnMAML1	Growing
dnMAML1_GCACTCTTCCTGCCAT	mVenus:dnMAML1	Growing
dnMAML1_GCAGCCACAGGGTACA	mVenus:dnMAML1	Growing
dnMAML1_GCAGCCATCAAACCGT	RIS from dnMAML1 co-culture	OIS
dnMAML1_GCAGCCATCCTCGCAT	mVenus:dnMAML1	Growing
dnMAML1_GCAGTTAAGCGATCCC	mVenus:dnMAML1	Growing
dnMAML1_GCAGTTACAACACCTA	mVenus:dnMAML1	Growing
dnMAML1_GCAGTTACACAAGCCC	mVenus:dnMAML1	Secondary senescence, mVenus:dnMAML1
dnMAML1_GCATACACACGGCCAT	mVenus:dnMAML1	Growing
dnMAML1_GCCAAATCATTAACCG	mVenus:dnMAML1	Growing
dnMAML1_GCGACCACACCAGTTA	mVenus:dnMAML1	Secondary senescence, mVenus:dnMAML1
dnMAML1_GCGCAACTCGGCATCG	mVenus:dnMAML1	Growing
dnMAML1_GCGCGATAGCTATGCT	mVenus:dnMAML1	Growing
dnMAML1_GCGCGATAGGTGTGGT	mVenus:dnMAML1	Growing
dnMAML1_GCTTCCATCATAACCG	mVenus:dnMAML1	Growing
dnMAML1_GGAAAGCGTGATGTGG	mVenus:dnMAML1	Secondary senescence, mVenus:dnMAML1
dnMAML1_GGAATAATCGCAAACT	mVenus:dnMAML1	Secondary senescence, mVenus:dnMAML1
dnMAML1_GGACAGACATTAGCCA	mVenus:dnMAML1	Growing
dnMAML1_GGACAGATCCATGAAC	mVenus:dnMAML1	Growing
dnMAML1_GGACATTCATCGTCGG	mVenus:dnMAML1	Secondary senescence, mVenus:dnMAML1
dnMAML1_GGAGCAACAAGAGTCG	mVenus:dnMAML1	Growing
dnMAML1_GGATGTTGTCAGAATA	mVenus:dnMAML1	Growing
dnMAML1_GGATTACAGCCGTCGT	mVenus:dnMAML1	Growing
dnMAML1_GGCAATTCATATGGTC	mVenus:dnMAML1	Growing
dnMAML1_GGCAATTGTAGTACCT	mVenus:dnMAML1	Growing
dnMAML1_GGCTCGAAGGGCTTCC	mVenus:dnMAML1	Growing
dnMAML1_GGCTGGTTCCAGAGGA	mVenus:dnMAML1	Growing
dnMAML1_GGGAATGGTTTGTTTC	mVenus:dnMAML1	Growing
dnMAML1_GGGAGATAGGAATCGC	mVenus:dnMAML1	Growing
dnMAML1_GGGAGATAGGACCACA	mVenus:dnMAML1	Growing
dnMAML1_GGGAGATAGGCATGGT	mVenus:dnMAML1	Growing
dnMAML1_GGGCACTTCAGGCGAA	mVenus:dnMAML1	Growing
dnMAML1_GTAACGTTCGTGGACC	mVenus:dnMAML1	Growing
dnMAML1_GTAACTGCAGTGAGTG	mVenus:dnMAML1	Secondary senescence, mVenus:dnMAML1
dnMAML1_GTACTCCGTCTGGTCG	mVenus:dnMAML1	Secondary senescence, mVenus:dnMAML1
dnMAML1_GTACTCCTCCTTTCTC	mVenus:dnMAML1	Growing
dnMAML1_GTAGGCCAGTGCCATT	mVenus:dnMAML1	Growing
dnMAML1_GTAGGCCGTCACCCAG	mVenus:dnMAML1	Growing
dnMAML1_GTAGTCAGTGATGCCC	mVenus:dnMAML1	Growing
dnMAML1_GTAGTCAGTTCGCGAC	mVenus:dnMAML1	Growing
dnMAML1_GTAGTCATCATCACCC	mVenus:dnMAML1	Secondary senescence, mVenus:dnMAML1
dnMAML1_GTCACGGAGCGAGAAA	mVenus:dnMAML1	Secondary senescence, mVenus:dnMAML1
dnMAML1_GTCATTTAGAAGGGTA	mVenus:dnMAML1	Growing
dnMAML1_GTCATTTCAGCTGTAT	mVenus:dnMAML1	Secondary senescence, mVenus:dnMAML1
dnMAML1_GTCATTTGTAGGCTGA	mVenus:dnMAML1	Growing
dnMAML1_GTCGGGTAGATGCCAG	mVenus:dnMAML1	Growing
dnMAML1_GTCGGGTAGTGCGTGA	mVenus:dnMAML1	Growing
dnMAML1_GTCTTCGTCACGACTA	mVenus:dnMAML1	Growing
dnMAML1_GTGAAGGGTGACAAAT	mVenus:dnMAML1	Growing
dnMAML1_GTGCAGCGTATCACCA	mVenus:dnMAML1	Growing
dnMAML1_GTGCGGTTCTTGCATT	mVenus:dnMAML1	Growing
dnMAML1_GTGCTTCCATCAGTAC	mVenus:dnMAML1	Growing
dnMAML1_GTGTTAGGTATTACCG	mVenus:dnMAML1	Growing
dnMAML1_GTGTTAGTCTCCAGGG	mVenus:dnMAML1	Growing
dnMAML1_GTTAAGCAGGCGTACA	mVenus:dnMAML1	Growing
dnMAML1_GTTCATTAGGCTATCT	mVenus:dnMAML1	Growing
dnMAML1_GTTCGGGCATAGAAAC	mVenus:dnMAML1	Growing
dnMAML1_GTTCGGGGTAGAGCTG	mVenus:dnMAML1	Growing
dnMAML1_GTTCTCGTCTCAACTT	mVenus:dnMAML1	Secondary senescence, mVenus:dnMAML1
dnMAML1_TAAACCGTCACAGTAC	mVenus:dnMAML1	Growing
dnMAML1_TACAGTGGTCGGCATC	mVenus:dnMAML1	Secondary senescence, mVenus:dnMAML1
dnMAML1_TACCTTATCTGCCAGG	mVenus:dnMAML1	Growing
dnMAML1_TACGGATCATGGGAAC	mVenus:dnMAML1	Growing
dnMAML1_TACGGTAAGCCCAATT	mVenus:dnMAML1	OIS
dnMAML1_TACTTGTTCCGCATCT	mVenus:dnMAML1	Growing
dnMAML1_TAGACCAAGAAACCAT	mVenus:dnMAML1	Growing
dnMAML1_TAGACCAAGGGTTTCT	mVenus:dnMAML1	Growing
dnMAML1_TAGACCATCTGCCAGG	mVenus:dnMAML1	Growing
dnMAML1_TAGAGCTGTCGAAAGC	mVenus:dnMAML1	Growing
dnMAML1_TAGAGCTTCCTGCAGG	mVenus:dnMAML1	Growing
dnMAML1_TAGCCGGTCTGGTGTA	mVenus:dnMAML1	Secondary senescence, mVenus:dnMAML1
dnMAML1_TAGTGGTCAGTCCTTC	mVenus:dnMAML1	Secondary senescence, mVenus:dnMAML1
dnMAML1_TAGTGGTTCAGGCAAG	mVenus:dnMAML1	Growing
dnMAML1_TAGTTGGTCGTTTGCC	mVenus:dnMAML1	Secondary senescence, mVenus:dnMAML1
dnMAML1_TAGTTGGTCTCCGGTT	mVenus:dnMAML1	Growing
dnMAML1_TATCAGGCATCACGAT	mVenus:dnMAML1	Growing
dnMAML1_TATCTCATCTGCCCTA	mVenus:dnMAML1	Growing
dnMAML1_TATGCCCAGCACCGCT	mVenus:dnMAML1	Growing
dnMAML1_TATGCCCAGCGGCTTC	mVenus:dnMAML1	Growing
dnMAML1_TATGCCCCAAGTCTGT	mVenus:dnMAML1	Growing
dnMAML1_TATTACCAGGGTGTTG	mVenus:dnMAML1	Growing
dnMAML1_TATTACCCATCACCCT	mVenus:dnMAML1	Growing
dnMAML1_TCAACGACAAACTGCT	mVenus:dnMAML1	Growing
dnMAML1_TCACAAGGTTCGTGAT	mVenus:dnMAML1	Growing
dnMAML1_TCACGAACACAGGTTT	mVenus:dnMAML1	Growing
dnMAML1_TCAGATGGTTTCCACC	mVenus:dnMAML1	Growing
dnMAML1_TCAGGATTCTCTAGGA	mVenus:dnMAML1	Growing
dnMAML1_TCAGGTAGTACTCTCC	mVenus:dnMAML1	Growing
dnMAML1_TCATTACGTCAAGCGA	mVenus:dnMAML1	Secondary senescence, mVenus:dnMAML1
dnMAML1_TCCACACTCGTTGCCT	mVenus:dnMAML1	Growing
dnMAML1_TCCCGATTCCACTCCA	mVenus:dnMAML1	Secondary senescence, mVenus:dnMAML1
dnMAML1_TCGAGGCCACTTGGAT	mVenus:dnMAML1	Growing
dnMAML1_TCGCGTTCAGGATTGG	mVenus:dnMAML1	Growing
dnMAML1_TCGGGACCAAGCCCAC	mVenus:dnMAML1	Secondary senescence, mVenus:dnMAML1
dnMAML1_TCGGTAACATCGGGTC	mVenus:dnMAML1	Growing
dnMAML1_TCGTACCAGCTCCCAG	mVenus:dnMAML1	Growing
dnMAML1_TCTCTAACACTGCCAG	mVenus:dnMAML1	Growing
dnMAML1_TCTCTAATCATTGCGA	mVenus:dnMAML1	Growing
dnMAML1_TCTCTAATCCAAGCCG	RIS from dnMAML1 co-culture	OIS
dnMAML1_TCTGAGAAGAATTGTG	mVenus:dnMAML1	Secondary senescence, mVenus:dnMAML1
dnMAML1_TCTTTCCAGGCTCATT	mVenus:dnMAML1	Secondary senescence, mVenus:dnMAML1
dnMAML1_TCTTTCCCACAGCCCA	mVenus:dnMAML1	Growing
dnMAML1_TGAGAGGTCCAGAGGA	mVenus:dnMAML1	Growing
dnMAML1_TGAGCCGAGACCGGAT	mVenus:dnMAML1	Growing
dnMAML1_TGAGCCGGTCCCGACA	mVenus:dnMAML1	Growing
dnMAML1_TGATTTCCAGATTGCT	mVenus:dnMAML1	Growing
dnMAML1_TGCACCTAGCCAGTAG	mVenus:dnMAML1	Growing
dnMAML1_TGCACCTGTTCACGGC	mVenus:dnMAML1	Growing
dnMAML1_TGCACCTTCAGAAATG	mVenus:dnMAML1	Growing
dnMAML1_TGCCCTAGTCCAAGTT	mVenus:dnMAML1	Growing
dnMAML1_TGCGCAGCAGACGTAG	mVenus:dnMAML1	Secondary senescence, mVenus:dnMAML1
dnMAML1_TGCGCAGTCAGTTGAC	mVenus:dnMAML1	Secondary senescence, mVenus:dnMAML1
dnMAML1_TGCGGGTAGCGTTTAC	mVenus:dnMAML1	Growing
dnMAML1_TGCGTGGCATGTTCCC	mVenus:dnMAML1	Growing
dnMAML1_TGCGTGGGTTGGTAAA	mVenus:dnMAML1	Growing
dnMAML1_TGCGTGGTCAACACCA	mVenus:dnMAML1	Growing
dnMAML1_TGCTACCCATTAGGCT	mVenus:dnMAML1	Growing
dnMAML1_TGCTACCGTTCCCTTG	mVenus:dnMAML1	Growing
dnMAML1_TGCTACCTCAGGATCT	mVenus:dnMAML1	Growing
dnMAML1_TGCTGCTTCCCTAATT	mVenus:dnMAML1	Growing
dnMAML1_TGGACGCCATGCCCGA	mVenus:dnMAML1	Secondary senescence, mVenus:dnMAML1
dnMAML1_TGGCCAGGTCAGATAA	mVenus:dnMAML1	Secondary senescence, mVenus:dnMAML1
dnMAML1_TGGGCGTAGGAATGGA	mVenus:dnMAML1	Growing
dnMAML1_TGGGCGTTCCTAAGTG	mVenus:dnMAML1	Secondary senescence, mVenus:dnMAML1
dnMAML1_TGTCCCATCCTCAACC	mVenus:dnMAML1	Growing
dnMAML1_TGTTCCGGTAACGACG	mVenus:dnMAML1	Growing
dnMAML1_TTAGGACCACTTGGAT	mVenus:dnMAML1	Growing
dnMAML1_TTAGTTCCACAACGCC	mVenus:dnMAML1	Growing
dnMAML1_TTATGCTCATCTCCCA	mVenus:dnMAML1	Growing
dnMAML1_TTCCCAGAGGGCACTA	mVenus:dnMAML1	Secondary senescence, mVenus:dnMAML1
dnMAML1_TTCTCAATCCCATTTA	mVenus:dnMAML1	Growing
dnMAML1_TTCTTAGAGCAACGGT	mVenus:dnMAML1	Secondary senescence, mVenus:dnMAML1
dnMAML1_TTCTTAGGTCGAATCT	mVenus:dnMAML1	Growing
dnMAML1_TTGAACGAGCTAGTTC	mVenus:dnMAML1	Growing
dnMAML1_TTGAACGAGGCACATG	mVenus:dnMAML1	Growing
dnMAML1_TTGACTTTCTTGAGGT	mVenus:dnMAML1	Growing
dnMAML1_TTGCCGTGTTAAAGTG	mVenus:dnMAML1	Growing
dnMAML1_TTGGAACGTAAGTTCC	mVenus:dnMAML1	Secondary senescence, mVenus:dnMAML1
dnMAML1_TTGGCAAAGAACAACT	mVenus:dnMAML1	Growing
dnMAML1_TTTACTGGTGAAGGCT	mVenus:dnMAML1	Secondary senescence, mVenus:dnMAML1
dnMAML1_TTTCCTCCATCACGAT	mVenus:dnMAML1	Growing
dnMAML1_TTTCCTCGTAGAGCTG	mVenus:dnMAML1	Secondary senescence, mVenus:dnMAML1
dnMAML1_TTTCCTCTCGTCCAGG	mVenus:dnMAML1	Growing
dnMAML1_TTTGCGCAGATATGCA	mVenus:dnMAML1	Growing
dnMAML1_TTTGCGCAGTGTTGAA	mVenus:dnMAML1	Secondary senescence, mVenus:dnMAML1
dnMAML1_TTTGCGCCACCGTTGG	mVenus:dnMAML1	Secondary senescence, mVenus:dnMAML1
dnMAML1_TTTGCGCGTGGTGTAG	mVenus:dnMAML1	Secondary senescence, mVenus:dnMAML1
